15
25
XXXXXXXXXXXXXXXXXXXXXXXXX
X           X           X
X  XXXXXXXXXXXXXXXXXXXX X
X                       X
X XXX X XXXXXXXXXXXXX   X
X   X X             X   X
X   X X             X   X
X   X X             X   X
X   X X             X   X
XXXXX XXXXXXXXXXXXXXX   X
X                      1X
XXXXX XXXXXXXXXXXXXXX   X
X   X X             X   X
X                   X   X
XXXXXXXXXXXXXXXXXXXXXXXXX